AP	AP
A	A
I	I
U	U
E	E1
O	O
ka/	k A
ki/	k I
ku/	k U
ke/	k E1
ko	k O
kya	ky A
kye	ky E1
kyi	ky I
kyo	ky O
kyu	ky U
sa/	s A
se/	s E1
si/	s I
so	s O
su/	s U
sha/	x A
she/	x E1
shi/	x I
sho	x O
shu/	x U
ta/	t A
te/	t E1
ti/	t I
to	t O
tu/	t U
ha/	h A
he/	h E1
hi/	h I
ho/	h O
hu/	h U
hya	hy A
hye	hy E1
hyi	hy I
hyo	hy O
hyu	hy U
ga/	g A
ge/	g E1
gi/	g I
go	g O
gu/	g U
gya	gy A
gye	gy E1
gyi	gy I
gyu	gy U
gyo	gy O
za/	z A
ze/	z E1
zi/	z I
zo	z O
zu/	z U
da/	d A
de/	d E1
di/	d I
do	d O
du/	d U
ba/	b A
be/	b E1
bi/	b I
bo/	b O
bu/	b U
pa/	p A
pe/	p E1
pi/	p I
po/	p O
pu/	p U
pya	py A
pye	py E1
pyi	py I
pyo	py O
pyu	py U
ja	j A
je	j E1
ji/	j I
jo	j O
ju/	j U
fa/	h A
fe/	h E1
fi/	h I
fo/	h O
fu/	h U
cha/	j A
che/	j E1
chi/	j I
cho	j O
chu/	j U
tsa	z A
tse	z E1
tsi	z I
tso	z O
tsu	z U
N	N
na/	n A
ne/	n E1
ni/	n I
no	n O
nu/	n U
nya	ny A
nye	ny E1
nyi	ny I
nyo	ny O
nyu	ny U
ma/	m A
me/	m E1
mi/	m I
mo/	m O
mu/	m U
mya	my A
mye	my E1
myi	my I
myo	my O
myu	my U
ra/	l A
re/	l E1
ri/	l I
ro	l O
ru/	l U
rya	ry A
rye	ry E1
ryi	ry I
ryu	ry U
ryo	ry O
ya/	y A
ye/	y E1
yi/	y I
yo/	y O
yu/	y U
wa/	w A
we/	w E1
wi/	w I
wo/	w O
wu/	w U